阿	ʔa
安	ʔɑn
婀	
鞅	
吾	ŋɑ ŋɔ
足	tsiok
英	ʔɨaŋ
惡	ʔak
菴	ʔəm ʔɨam
奄	ʔɨəmʔ
闇	ʔəmh
鴨	
姶	
愛	ʔəs ʔəh
婆	bɑi
伐	buɑt
麼	mɨɑiʔ mɨɑi mɨe
魔	
磨	mɑi ma
薄	bak pʰak
倍	bəʔ
陪	bə
毎	məʔ
鼻	bit bis
毘	bi
婢	bieʔ
彌	mie mieʔ
寐	mis
弭	mieʔ
妣	piʔ pih
煩	buan
夫	buɑ puɑ
扶	buɑ puɑ
部	boʔ
父	buɑʔ puɑʔ
府	puoʔ
歩	bɑh
矛	mu
符	buo
鶩	muoh
備	bɨəh bɨh
肥	bui
媚	mɨh
眉	mɨ muiʔ
縻	mɨe
謎	meih
大	dɑh das
太	tʰɑs
陁	ḍiaiʔ
騨	dɑi dan
娜	
嚢	nɑŋ naŋ
儾	nɑŋ
談	dam
弾	dan
傳	ḍyan
殿	denh
代	dəh
堤	de
提	teh de
低	tei
田	den
弟	deiʔ
泥	nei neih neiʔ
埿	nei neiʔ neih
涅	net
耐	nəh
遲	ḍih
治	ḍiə ḍiəh
地	dih
尼	ṇi neih
旎	ṇe
膩	ṇis
道	douʔ
路	lah lɔh
縢	dəŋ
杼	ḍiɑʔ
騰	dəŋ
藤	dəŋ
特	dək
迺	nəʔ
頭	do
豆	doh
逗	doh
圖	dɑ
弩	nɑʔ naʔ
砮	nɑ naʔ
曇	dəm
土	tʰɑʔ
度	dɑh
渡	dɑh
奴	nɑ
怒	nɑh naʔ
衣	ʔɨi ʔɨih
亞	ʔah
依	ʔɨi
哀	ʔəi
埃	iə
榎	kah
荏	ńimʔ
得	tək
朴	pok
我	ŋɑiʔ
奇	kɨɑi kɨai ɡɨai
宜	ŋɨɑi
賀	ɡɑih
何	ɡai
河	ɡɑi
蛾	ŋɑi
餓	ŋɑih
峨	ŋai
俄	ŋɑi
鵝	ŋɑi
義	ŋɨɑih
礙	ŋəh
碍	ŋəh
皚	
祇	kie ɡɨi gɨi
藝	ŋias
儀	ŋɨɑi
蟻	ŋɨɑiʔ
𡺸	ɡɨ
其	ɡɨə
期	ɡɨə kɨə
碁	ɡɨə
凝	ŋɨəŋ
語	ŋɨɑʔ ŋɨɑh
馭	ŋîɑ
御	ŋɨɑh ŋɨah
具	ɡuoh
遇	ŋɨoh
娯	ŋyɑ ŋuɔ
求	ɡu
隅	ŋɨo
愚	ŋɨo
虞	ŋyɑ
群	ɡun
疑	ŋɨə
擬	ŋɨəʔ
胡	ɡɑ ɡɔ
候	ɡo
後	ɡoʔ ɣoʔ
誤	ŋuɑh ŋuoh
呉	ŋuɑ ŋuɔ
悟	ŋɑh ŋɔ
下	ɡaʔ
牙	ŋa
介	kɛs
雅	ŋaʔ
夏	ɡaʔ
霓	ŋe ŋet
伊	ʔi
夷	ji
移	jɑi jai je
已	jəʔ jɨʔ
異	jəh
以	
怡	jə
易	jeh jek
射	źak źah
五	ŋɑʔ
膽	tɑmʔ
因	ʔin
印	ʔinh
揖	tsip
壹	ʔit
加	kai
居	kɨɑ kɨɑh
迦	ka
可	khɑiʔ
訶	hɑi
哥	kɑi
歌	kɑi
哿	kɑiʔ
珂	khɑi
箇	kaih
嘉	kai
架	kah
伽	ɡa
舸	khɑi
柯	kɑi
軻	khɑi khɑih khɑiʔ
香	hɨɑŋ
髪	puɑt
蚊	mun
鹿	lok
芳	pʰuɑŋ
歟	jɑ
各	kɑk
覺	kɔk
甘	kɑm
含	ɡəm
敢	kɑmʔ
干	kɑn
閑	ɡɛn
漢	hɑnh
甲	kap
合	ɡəp
韓	ɡan
葛	kɑt
考	khouʔ
既	kɨs kɨj
希	hɨi
擧	kɨɑʔ
氣	kɨs kɨj
戒	kɛh
開	khəi
該	kə
慨	khəh
概	kəh
凱	khəi
愷	khəi
階	kɛi
毛	mau
食	źɨk
飼	ziəh
消	siau
笥	siəh
支	tśe
耆	ɡɨ
岐	ɡie
吉	kit
枳	kieʔ
棄	khis
伎	kie
企	khieʔ khieh
祁	ɡɨ
來	lə
寸	tshuənh tshənh
杵	tśhɑʔ
己	kɨəʔ kɨə
許	hɨɑ
去	khɨɑh
巨	ɡɨɑʔ ɡyaʔ
虚	hɨɑ
忌	ɡɨəh
莒	kɨɑʔ
據	kɨɑh
渠	ɡɨɑ
木	mok
興	hɨŋ
極	ɡɨk
今	kɨm
金	kɨm
感	kəmʔ
紺	kəmh
近	ɡɨnʔ
乞	khɨt
久	kuʔ kɨu
跪	ɡyaiʔ khyaiʔ
垝	kyaiʔ
苦	khɑʔ khah
句	ko
玖	ku kɨu
口	khoʔ
丘	khu
九	kuʔ
鳩	ku
孔	khoŋʔ
倶	kɨo
區	khuo
矩	kyɑʔ
絇	ɡɨo
窶	ɡuo
衢	ɡyɑ
屨	kuo
功	koŋ
菊	kuk
鞠	kuk
君	kun
訓	hunh
忽	huət
骨	kuət
鬼	kuiʔ
貴	kuis
歸	kui
紀	kɨəʔ
幾	kɨiʔ
記	kɨəh
寄	kɨaih
綺	khʔaiʔ
騎	ɡɨɑih
機	kɨi
基	kɨə
城	dźeŋ ɡieŋ
黄	ɣuaŋ
樹	dźoʔ
古	kɑʔ kɔ
觚	kua kuɔ
高	kau
固	kɑh kɔ
故	kɑh kɔ
庫	khɑh
祜	ɡɑʔ ɡɔʔ
枯	khɑ kɔ
姑	kɑ kɔ
孤	kuɑ kuɔ
顧	kɑh kɔ
子	tsiəʔ
兒	ńe
小	siauʔ
籠	loŋ loŋh
粉	punʔ
奚	ɡe
家	ka
計	keih
鷄	ke
谿	khe
價	kah
賈	kah
結	ket
係	keh ɡeh
稽	kei kheiʔ
啓	kheiʔ
溪	khe
兼	kem kemh
監	kam
險	hɨamʔ
馬	maʔ
麻	mai ma
末	mat
昧	məs
滿	manʔ
莫	mak mah
明	mɨaŋ
萬	muɑnh
摩	mɑi ma
莽	mɑŋʔ mɑʔ
間	kɛn
目	muk
信	sinh
眞	tśin
望	muaŋ
幕	mak
米	meiʔ
梅	mə
迷	mei
妹	məs
眼	ŋɛnʔ
美	mɨʔ
瀰	mieʔ
民	min
湄	mɨ
三	sam səm
見	kenh
水	tśuiʔ śuiʔ
參	tshəm s̘im
視	ɡiʔ ɡih
敏	mɨənʔ
母	məʔ
文	mun
茂	muh
暮	mah
慕	mah
謀	muə mu
墓	mah
悶	mən
聞	mun
忘	muaŋ
蒙	moŋ
門	mən
問	munh
勿	mut
畝	məʔ moʔ
物	mut
裳	dźaŋ
藻	tsauʔ
喪	saŋ
哭	khok
裙	ɡun
没	muət
牟	mu
武	muaʔ
模	ma mɔ
無	mua
无	mua
務	muoh
霧	muoh
夢	muŋ
鵡	muaʔ
儛	muɑʔ
六	liuk
身	śin
未	mus
味	mus
微	mui
尾	muiʔ
實	źit
箕	kɨə kɨ
密	mɨt
謨	ma mɔ
賣	mɛh
咩	
面	mianh
綿	mian
女	ṇiaʔ
婦	buʔ
那	nɑi nɑ
難	nɑn
乃	nəʔ
奈	nɑs nɑi
儺	nɑi
寧	neŋ
名	mieŋ
魚	ŋɨɑ
中	ṭuŋ
菜	tshəh
七	tshit
諾	nak
南	nəm
冉	ńamʔ
禰	neʔ
年	nen
根	kən
嶺	lieŋʔ
念	nemh
爾	ńeʔ
貳	ńis ńih
二	ńis
仁	ńin
邇	ńeʔ
日	ńit
而	ńə ńɨ
耳	ńəʔ ńɨʔ
珥	ńəh
儞	neʔ
丹	tan
荷	ɡɑiʔ
煮	tśɑʔ
似	ziəʔ
瓊	ɡyeŋ
入	ńip
能	nə nəŋ
廼	nəʔ
笶	śiʔ
箆	bi bei
柔	ńu
蕤	ńui
努	naʔ
農	nouŋ
濃	ṇioŋ noŋ
沼	tśauʔ
宿	siuk siuh
渟	deŋ
潤	ńuinh
野	jaʔ
意	ʔɨəh
於	ʔɨɑ
淤	ʔɨɑ
飫	ʔɨɑh
憶	ʔɨək
應	ʔɨŋh
隠	ʔɨnʔ
音	ʔɨm
磤	
邑	ʔip
乙	ʔɨt
巴	pa
伴	pʰanh
半	panh
叵	
波	pɑi
播	pɑih
幡	pʰuɑn
破	pʰɑih
方	puɑŋ puaŋ
防	buɑŋ
八	pɛt
判	pʰanh
胖	pʰanh
簸	pɑih paiʔ
泮	pʰɑnh
絆	panh
房	buaŋ
泊	bak
盤	ban
皤	bɑi
羽	waʔ
齒	tśhəʔ
葉	jap
者	tśaʔ
博	pak
伯	pak
法	puap
閉	pes pet
閇	pes pet
拜	pɛs
背	bəh pəh
杯	pə
俳	bɛi
沛	pɑs
珮	bəh
戸	ɡɑʔ ɡɔ
綜	tsouŋh
經	keŋ
甕	ʔoŋh
缻	
卑	pie
比	piʔ
必	pit
賓	pin
臂	pieh
避	bieh
譬	pʰieh
嬪	bin
檜	kuɑs kuat
氷	pɨŋ
富	puh
費	pʰus
番	pʰuɑn
蕃	puɑn
朋	bəŋ
裒	po
袍	bou
火	huɑiʔ
焰	ziam zim
帆	buam
品	pʰimʔ
不	pu puʔ
服	buʔ buk
布	pɑh
甫	puɑʔ
賦	puɑh
福	puk
否	puəʔ puʔ
敷	pʰuɑ
赴	pʰuoh
負	buəʔ buʔ
浮	bu
輔	buɑʔ
経	keŋ keŋh
歴	lek
乾	kɑn ɡɨan
鳳	buəmh
弗	put
皮	bɨɑi bɨe
非	pui
斐	pʰuiʔ
飛	pʰui
悲	pɨ
彼	pɨɑiʔ
祕	pɨs
妃	pʰui
被	pʰɨɑi bɨɑih
樋	
熯	hɑnʔ
菩	bo
本	pənʔ
保	pouʔ
寶	pouʔ
譜	
報	pouh
褒	pou
抱	bouʔ
穗	zuis
百	pak
凡	buam
俾	pieʔ
邊	pen
反	puanʔ
返	puanʔ
遍	penh
辧	bɨanh
平	bɨɛŋ
覇	pah pʰak
敝	bias
弊	bias
幣	bias
蔽	pias
陛	beiʔ
鼙	be
鞞	pieʔ
重	ɖioŋʔ ɖioŋ
隔	kɛk
篇	pʰian
羅	lai la
邏	lɑi lɑ
良	liaŋ
浪	laŋ
郎	laŋ
廊	laŋ
莨	lɑŋ
囉	lɑi lɑ
攞	lɑi lɑ
𡤢	
𧟌	
樂	lak
落	lak
覽	lamʔ
藍	lam
濫	lamh
臘	lap
例	lias liah
禮	leiʔ
連	lianʔ
列	liat
烈	liat
戻	let les
黎	lei
廉	liam
利	lih
離	liai
理	liəʔ
里	liəʔ ljɨʔ
隣	lin
唎	
梨	li
釐	liə
慮	liɑh
呂	liɑʔ
侶	liɑʔ
閭	lia
勒	lək
廬	liɑ
稜	lɨŋ
綾	lɨŋ
流	liu
留	liu
琉	
瑠	
屢	lioh
漏	loh
樓	lo
婁	lioʔ lo
蘆	lia
盧	la lɔ
類	luis
鹵	lɑʔ lɔʔ
魯	lɑʔ lɔʔ
露	lah lɔh
沙	s̘ai
佐	tsɑiʔ
左	tsaiʔ
差	tshai
娑	sai
柴	dʑɛ
舎	śaʔ śah
作	tsɑk
紗	
草	tshouʔ
瑳	tshɑiʔ
磋	tshɑi
狹	ɡɛp
猿	wan
相	siaŋ siaŋh
倉	tshaŋ
積	tsiek tsieh
尺	tśhak
釋	śak
跡	tsiak
散	sanʔ sanh
戔	dzan
贊	tsanh
讃	tsanh
雜	dzəp
匝	tsəp
颯	səp
薩	
刷	ṣuat
早	tsouʔ
最	tsuas
斯	sie
齊	dzei
西	sei
洒	ṣɛiʔ
施	śɑi
勢	śas
世	śas
制	tśas
細	seih
栖	sei sen
是	dźeʔ
劑	dzeih
瀬	lɑs
湍	tʰuɑn
脊	tsiek
迫	pak
瞻	tśam
資	tsi
次	tshih tshis
之	tśə
尸	śi
師	ṣi
新	sin
思	siə
四	sis sih
司	siə
志	tśəh
紫	tsieʔ
芝	tśiə
詩	śə
旨	kiʔ tśiʔ
寺	ziəh
指	kiʔ tśiʔ
死	siʔ
此	tshieʔ
時	dźə
偲	siə
詞	ziə
嗣	ziəh
辭	ziə
試	śəh
璽	sieʔ
始	śəʔ
伺	siə siəh
自	dzih
絁	śɑi
茲	dziə tsiə
矢	śiʔ
洎	
爲	wɑi wai
磯	kɨi
鍾	tśoŋ
鐘	tśoŋ
餝	śɨk
色	ṣək
式	śɨk
拭	śɨk
叔	śuk
襲	zip
質	tśit
漆	tshit
曾	tsəŋ
所	ṣɑʔ
增	tsəŋ
噌	səŋ
僧	səŋ
則	tsək
諸	tśɑ
贈	dzəŋh
層	dzəŋ
賊	dzək
苑	ʔyanʔ wunʔ
須	sio
周	tśu
州	tśu
酒	tsiuʔ
洲	tśu
酢	dzɑk
主	tśoʔ
珠	tśo
數	ṣoʔ
種	tśoŋ
衆	tśuŋh
春	tśhuin
秀	siuh
殊	dźo
輸	śo
素	sɑh sɔh
蒭	tṣho
樔	dẓau
簀	tṣɛk
渚	tśɑʔ tśɔʔ
淑	dźuk
駿	tsuinh
蘇	sɑ sɔ
巷	ɡɔŋh
嗽	soh
宗	tsouŋ
祖	tsɑʔ tsɔʔ
泝	sɑh sɔh
十	dźip
多	tɑi tɑ
哆	tśhɑiʔ
侈	tśhai
他	tʰai
託	tʰak
黨	tɑŋʔ
陀	dai
柁	ṭiaiʔ
柂	ṭiaiʔ
駄	
手	śuʔ
當	taŋ
宕	daŋh
宅	ḍak
澹	damʔ damh
淡	damʔ damh
倓	dam damh
覃	dəm
潭	dəm
旦	tanh
但	danʔ
檀	dan
答	təp
塔	tʰap
帶	tas
達	tʰat dat
鞮	te de
弖	teiʔ
天	tʰen
帝	teh
底	
諦	teh
題	de
直	ḍiə ḍɨk
點	temʔ
智	ṭieh
知	ṭie
至	tśis
致	ṭis
恥	ṭhiəʔ
陳	ḍin
笞	ṭʰiə
池	ḍiai
馳	ḍiai
鎭	ṭin
千	tshen
茅	mɔu
血	huet
乳	ńoʔ
敕	ṭhɨk
珍	ṭɨn
秩	ḍit
臺	də
登	təŋ
止	tśəʔ
等	təŋʔ
澄	ḍɨŋ ḍaŋ
台	tʰə
苔	də
鄧	dəŋh
鳥	teuʔ
迹	tsiak
常	dźaŋ
徳	tək
對	tuəs
都	tɑ tɔ
通	tʰoŋ
追	ṭui
丑	ṭhuʔ
川	tśuan
菟	tʰɑ tʰɔ tʰa
屠	da
途	dɑ
徒	dɑ
突	tʰuət duət
覩	tɑʔ
津	tsin
筑	ṭuk
築	ṭuk
竹	ṭuk
竺	touk
敦	tuən
綴	ṭyat ṭyas
刀	tɑu
斗	toʔ
妬	tah
杜	dɑʔ
塗	dɑ
聰	tshoŋ
鋭	juas
砥	tśiʔ
速	sok
疾	dzit
礪	lias
于	wɑ
有	wuʔ
宇	wɑʔ
汚	ʔua
烏	ʔa ʔɔ
紆	ʔyɑ
兎	tʰɔ
鵜	dei
卯	mɔuʔ
鸕	lɑ
雲	wun
鬱	ʔut
倭	ʔyai
獲	ɣuak
委	ʔyai ʔyaih
和	ɣuai
涴	ʔuan
王	waŋ
丸	ɣuan
輪	luin
曲	khuok
曰	wat
穢	ʔyas
衞	was wah
惠	ɣues ɣueh
佪	ɣuəi
廻	ɣuəi
慧	ɣues ɣueh
隈	ʔuəi
坐	dzuaiʔ
畫	ɣuɛh ɣuɛk
座	dzuɑih dzuɑiʔ
咲	siauᶜ tsʰiauᶜ
位	wɨs wih
韋	wui
威	ʔui
謂	wus wuh
偉	wiuʔ
萎	ʔyai
井	tsieŋʔ
猪	tra
藺	linh
員	wun wan
呼	ha hah
塢	ʔɑ
乎	ɦa ɣɔ
雄	wuŋ
袁	wan
遠	wanʔ
怨	ʔyanh
弘	ɣuəŋ
雍	ʔuoŋ
越	wat
嗚	ʔa
惋	ʔuanʔ
少	śauʔ śauh
男	nəm
緒	ziaʔ
綬	dźuh
峽	ɡɛp
𠮧	keuh
邪	ja zia
益	ʔiek
耶	ja
夜	jah
也	jaʔ
楊	jaŋ
陽	jaŋ
揚	jaŋ
椰	
揶	
瑘	
掖	jak
養	jaŋʔ
屋	ʔok
箭	tsianh
鹽	jam
延	jan
叡	juas
曳	jas
遥	jau
要	ʔiauh
穎	weŋʔ
兄	hyaŋ
江	kɔŋ
枝	kie
炎	jam
與	ja
餘	ja
余	ja
豫	jah
預	jaʔ
予	jah
譽	ja
由	ju
喩	joh
遊	ju
油	ju
瑜	jo
踰	jo
愈	joʔ
臾	jo
庾	joʔ
弓	kuŋ
湯	tʰaŋ
用	joŋh
欲	jok
容	joŋ
庸	joŋ
𠰩	joŋh
奢	śa
蔵	dzɑŋ
社	dźaʔ
謝	ziah
奘	dẓɑŋh
裝	dẓɑŋh
蹔	
筮	dźas
噬	dźas
士	dẓəʔ
盡	dzinʔ dzinh
慈	dziə
仕	dẓəʔ
茸	ńoŋ
餌	ńəh
深	tśim śim
甚	dźimʔ dźimh
敍	ziɑʔ
存	dzən
序	ziɑʔ
鋤	dẓɑ
鐏	dzuənh
茹	ńɑʔ ńɑh
受	dźuʔ
授	dźuh
聚	dzioʔ dzioh
儒	ńo
孺	ńoh
俗	ziok
